160

===================================
=@0#*******00000$000000##000=====X=
=00#===================#0FF##**FF0=
=00#==================##!!!!##****=
=00==00000=0########0=0##0000##***=
=00==00000=0#!!!!!!#0=00##!!!!##00=
=00==000$00^#!****!#^=000##0000##0=
=00==0000000#!*KM*!#0=0000##!!!!#0=
=00==000===0#!*TW*!#0=00000##00000=
=00==000===0#!****!#0=000000##!!!0=
=====000===^#!!!!!!#^=000^000##00#=
=00==000===0########0=00000000##!#=
=00==00X===0000000000=00$000000###=
=00==000==============000^000$00##=
=^0==00^0000000000000000000000000#=
=00==0000000000000000000FFFFFF^FF#=
=X0$000=0000000000000000000000000X=
===================================