120

===================================
=K!!0*00000000!00000000*000!0000M==
=!!00*000000000000F0000*000!00000==
=!#!0*00X00000000000000*000!0FX00==
=00X0*#0000000$00000000*000!!!!!!==
=0000*#000############0*000000000==
=0000*#000**========**0*000X00000==
=00*0*#000**=@0$0X==**0*000000000==
=0F00*#000**========**0*000000000==
=0000*#000############0*000000000==
=0000*#000000000000*000*000000000==
=0000*#0000000000000000*000!!!!!0==
=0000*#000!00000$00*000*0000X0000==
=0000*#0000FFFF00000000*0X0!00000==
=0000*******************000000000==
=0000*0000000000X000000*000000000==
=W000*^00000^0000!000F0*00!00F00T==
===================================